1111111111111111111
10000000000P0000001
1C100000111111000P1
1000000011111100001
1E0000C0111111C0001
1111111111111111111