1111111111111111111
1000000000000000001
1C100000111111000P1
1100000011111100001
1E1000C0111111C0001
1111111111111111111