1111111111111111111
100000000U000000001
1C100000111111000P1
1000000011111100001
1E0000C0111111C0001
1111111111111111111